11111111111111111
1P000000000000001
10000000000000001
10000000E000000C1
11111111111111111