11111111111111111
1P000000000C00001
10000C00000000001
1000C0000000000E1
11111111111110111